##########
#S       #
#  #### ##
#  #      #
#  # #### #
#  #    # #
### ## # #
#      #  #
#########E#