##########
#S        
#  ####   
#     #   
#     #   
##########