#######################
## E E E        S######
############  #########
#########  ##########  
#                      
#######################
#######################
#######################
##########  ###########