#################################################
#                                               #
# ##############################                #
# #                            #                #
# # ######################     #                #
# #S#                        #####              #
# # # ######################     #              #
# # # #                            #            #
# # # # #############################           #
# # # # #                                       #
# # # # # ##################################### #
# # # # #                                       #
# # # # # #######################################
# # # # #         ##                            #
# # # # # ##################################### #
# # # # #         #                             #
# # # # # ##################################### #
# # # # #                                       #
# # # # # ##################################### #
# # # # #                                       #
# # # # # ##################################### #
# # # # #                                       #
# # # # # ##################################### #
# # # # #                                       #
# # # # # ##################################### #
# # # # #                                       #
# # # # # ##################################### #
# # # # #                                       #
# # # # # ##################################### #
# # # # #                                       #
# # # # # ###################################### 
# # # # #                                       #
# # # # # ##################################### #
# # # # #                                       #
# # # # # ###################################### 
# # # # #                                       #
# # # # # ###################################### 
# # # # #                                       #
# # # # # ##################################### #
# # # # #                                       #
# # # # # ###################################### 
# # # # #                                       #
# # # # # ###################################### 
# # # # #                                       #
# # # # # ###################################### 
# # # # #                                       #
# # # # # ##################################### #
# # # # #                                       #
# # # # # ##################################### #
# # # # #                                       #
# # # # # ##################################### #
# # # # #                                       #
# # # # # ##################################### #
# # # # #                                       #
# # # # # ##################################### #
# # # # #                                       #
# # # # # ##################################### #
# # # # #                                       #
# # # # # ##################################### #
# # # # #                                       #
# # # # # ##################################### #
# # # # #                                       #
# # # # # ##################################### #
# # # # #                                       #
# # # # # ##################################### #
# # # # #                                       #
# # # # # ##################################### #
# # # # #                                       #
# # # # # ##################################### #
# # # # #                                       #
# # # # # ##################################### #
# # # # #                                       #
# # # # # ##################################### #
# # # # #                                       #
# # # # # ##################################### #
# # # # #                                       #
# # # # # ##################################### #
# # # # #                                       #
# # # # # ##################################### #
# # # # #                                       #
# # # # # ##################################### #
# # # # #                                       #
# # # # # ###################################### 
# # # # #                                       #
# # # # # ###################################### 
# # # # #                                       #
# # # # # ##################################### #
# # # # #                                       #
# # # # #                                       #
# # # # # ##################################### #
# # # # #                                       #
# # # # # ###################################### 
# # # # #                                       #
# # # # # ##################################### #
# # # # #                                      E#
# # # # # ##################################### #
