#################################################
#                                               #
# ##############################                #
# #                            #                #
# # ######################     #                #
# #S#                        #####              #
# # # ######################     #              #
# # # #                            #            #
# # # # #############################           #
# # # # #                                       #
# # # # # ##################################### #
# # # # #                                       #
# # # # # ##################################### #
# # # # #                                       #
# # # # # ##################################### #
# # # # #                                       #
# # # # # ##################################### #
# # # # #                                       #
# # # # # ##################################### #
# # # # #                                       #
# # # # # ##################################### #
# # # # #                                       #
# # # # # ##################################### #
# # # # #                                       #
# # # # # ##################################### #
# # # # #                                       #
# # # # # ##################################### #
# # # # #                                       #
# # # # # ##################################### #
# # # # #                                       #
# # # # # ##################################### #
# # # # #                                       #
# # # # # ##################################### #
# # # # #                                       #
# # # # # ##################################### #
# # # # #                                       #
# # # # # ##################################### #
# # # # #                                       #
# # # # # ##################################### #
# # # # #                                       #
# # # # # ##################################### #
# # # # #                                       #
# # # # # ##################################### #
# # # # #                                       #
# # # # # ##################################### #
# # # # #                                       #
# # # # # ##################################### #
# # # # #                                       #
# # # # # ##################################### #
# # # # #                                       #
# # # # # ##################################### #
# # # # #                                       #
# # # # # ##################################### #
# # # # #                                       #
# # # # # ##################################### #
# # # # #                                       #
# # # # # ##################################### #
# # # # #                                       #
# # # # # ##################################### #
# # # # #                                       #
# # # # # ##################################### #
# # # # #                                       #
# # # # # ##################################### #
# # # # #                                       #
# # # # # ##################################### #
# # # # #                                       #
# # # # # ##################################### #
# # # # #                                       #
# # # # # ##################################### #
# # # # #                                       #
# # # # # ##################################### #
# # # # #                                       #
# # # # # ##################################### #
# # # # #                                       #
# # # # # ##################################### #
# # # # #                                       #
# # # # # ##################################### #
# # # # #                                       #
# # # # # ##################################### #
# # # # #                                       #
# # # # # ##################################### #
# # # # #                                       #
# # # # # ##################################### #
# # # # #                                       #
# # # # # ##################################### #
# # # # #                                       #
# # # # # ##################################### #
# # # # #                                       #
# # # # # ##################################### #
# # # # #                                       #
# # # # # ##################################### #
# # # # #                                       #
# # # # # ##################################### #
# # # # #                                       #
# # # # # ##################################### #
# # # # #                                       #
# # # # # ##################################### #
# # # # #                                       #
# # # # # ##################################### #
# # # # #                                       #
# # # # # ##################################### #
# # # # #                                       #
# # # # # ##################################### #
# # # # #                                       #
# # # # # ##################################### #
# # # # #                                       #
# # # # # ##################################### #
# # # # #                                       #
# # # # # ##################################### #
# # # # #                                       #
# # # # # ##################################### #
# # # # #                                       #
# # # # # ##################################### #
# # # # #                                       #
# # # # # ##################################### #
# # # # #                                       #
# # # # # ##################################### #
# # # # #                                       #
# # # # # ##################################### #
# # # # #                                       #
# # # # # ##################################### #
# # # # #                                       #
# # # # # ##################################### #
# # # # #                                       #
# # # # # ##################################### #
# # # # #                                       #
# # # # # ##################################### #
# # # # #                                       #
# # # # # ##################################### #
# # # # #                                       #
# # # # # ##################################### #
# # # # #                                      E#
# # # # # ##################################### #
