################
#S             #
############## #
############## #
############## #
############## #
############## #
############## #
############## #
############## #
############## #
############## #
############## #
############## #
################
