+-------------------+
|@  #S $  %  ^  &  *|
|*  &  ^  %  $  #  @|
|@  #  $  %  ^  &  *|
|*  &  ^  %  $  #  @|
|@  #  $  %  ^  &  *|
|*  &  ^  %  $  #  @|
|@  #  $  %  ^  &  *|
|*  &  ^  %  $  #  @|
|@  #  $  %  ^  &  *|
|*  &  ^  %  $  #  @|
|@  #  $  %  ^  &  *|
|*  &  ^  %  $  #  @|
|@  #  $  %  ^  &  *|
|*  &  ^  %  $  #  @|
|@  #  $  %  ^  &  *|
|*  &  ^  %  $  #  @|
|@  #  $  %  ^  &  *|
|*  &  ^  %  $  #  @|
|@  #  $E %  ^  &  *|
+-------------------+
